
NO first
SO Hello
WE There
EA Hi
EA BOO
F 89,9,0
C 89,0,0

11111   111  
11101   1N11
11111   111                  